30
* o B + + + o o o o o G + + + + + * + + 
* o B + + + o o o o o G + + + + + * + + 
* o B + + + + * * * G G + + + + + * + + 
* o B + + + + o > o . . . . . + + + + + 
* o B + + + # # . o o . . . . # # + + + 
* o B + + + # # # # # . . . . # # + + + 
* o B + + + * * * * * + . . . # # + + + 
* o B + + + + o + o + + + + + * * + + + 
* o B + + + + * * * + + + + * * * * + + 
* + + + + + + + + + + + + + + + + + + + 