12
. . + + + + + . . . . . . . . . o . . . 
. + + + + + + + . . . . . . + + + + . + 
+ + + + + + + + + . . . . o # # # # + # 
# * # # # # # # # + . . o # . . * * * * 
o # . . . . . . . # + . # . . . # # # # 
o . . * o * * . o . # * # . . # + + + + 
o > . # * o # . * . . # . . . # + + + + 
* . # + # # + # o o . . . . # + + + + + 
o # + + + + + + # # o . o # + + + + + + 
# + + + + + + + + + # # # + + + + + + + 
