32
* o o o o + + + # o o o * o . . . . 
o * * * * * * * + o o o o o o . * o 
o * + + + o o o o * . * + # o o # o 
o * + # + * o o o o . * + + + o * o 
o * + . . * o o o o . # . . + + + # 
o * + # + * o * * o o + * # # # # o 
o * . # + * o * # > o + * + o o o o 
+ + . . . o o o # o o . . . # + + + 
o o + + + + # + o + . # + # . o o * 
o o + + + + . + . . . + + . . . o * 
o o + + + + . + . . . + + . . . o * 
