9
* + + + + + + + + + + + + + + + + + + * 
+ + + + + + + + + + + + + + + + + + + + 
+ + + + + # . * # # # # + # + + + + + + 
+ + + + + # # . * # # # + # + + + + + + 
+ + + + + # # # . * # # > # + + + + + + 
+ + + + + # # # # . * # # # + + + + + + 
+ + + + + # # # # # . * # # + + + + + + 
+ + + + + + + + + + + + + + + + + + + + 
+ + + + + + + + + + + + + + + + + + + + 
* + + + + + + + + + + + + + + + + + + * 
